어릴 때	어린때
없는 것 같아	없는같아
없어	게없어
좋아	게좋아
많아	게많아
좋은 것 같아	좋은같아
힘든 것 같아	힘든같아
어려운 것 같아	어려운같아
대단한 것 같아	대단한같아
짜증남	짜증남
생크림	생크림
생각남	생각남
밖에 없어	밖없어
아름다운	아름다운
감성 팔이	감성팔
말도 안돼	말안
부드러워	부드러워
아니요	아니요
큰 것 같아	큰같아
인정 하는	인정하
시원해	시원해
1도 관심	1관심
1도 관심 없어	1관심없어
이해 안돼	이해안
짜증 날듯	짜증날
연락 안해	연락안
~인것 같아	인같아
같아	같아
좋아	좋아
친구랑	친구이랑
생각 안해	생각안
소화 안돼	소화안
감당 안돼	감당안
걱정마	걱정마
시청률 안나와	시청률안나
강요안해	강요안
인정 안해	인정안
얼마 안가	얼마안
화날 때	화난때
안 보여	안보이
비교 안해	비교안